Megan	F
Joseph	M
Kyle	M
Katie	F
Abby	F
Nathan	M
Liesl	F
Ian	M
Colin	M
Peter	M
Michael	M
Thomas	M
Devri	F
Ben	M
Aubrey	F
Rebecca	F
Will	M
Max	M
Rianne	F
Avery	F
Lauren	F
Becca	F
Gregory	M
Sarah	F
Robbie	M
Keaton	M
Carter	M
Teddy	M
Gabrielle	F
Grace	F
Emily	F
